16 16

╔╦╦══╦═╦════╦╦╦╗
╠╬╣██║█║████║║╚╣
╠╩╬══╬═╣████╚╩═╣
║█║██║█║███████║
║█║██║█║███████║
╠═╬══╬╦╣██████╔╝
║█║██╠╬╣██████║█
╠═╩══╩╩╝██████╚╗
║██████████████║
║██████████████║
║██████████████║
║████╔═╦╦═╗████║
║███╔╣█╠╣█╠╗███║
║██╔╝╚═╩╩═╝╚╗██║
║█╔╝████████╚╗█║
╚═╝██████████╚═╝

9
0 14
0 7
7 0
11 0
15 3
14 6
15 14
14 15
1 15

UP
