########################################
#......................................#
#......................................#
#......................................#
#......................................#
#......................................#
#......................................#
#......................................#
#......................................#
#......................................#
#......................................#
#......................................#
#......................................#
#......................................#
#......................................#
#......................................#
#......................................#
#......................................#
#......................................#
#...................#..................#
#...................#..................#
#...................#..................#
#...................#..................#
#...................#..................#
#...................#..................#
#...................#..................#
#...................#..................#
#...................#..................#
#.P................T#T...............P.#
########################################